11111111111111111111111111111111111111111111
1P000000000000000000000000000000000000000001
10000000100000010000000000001111111100000001
10000000100000010000CCCC00000000000100000001
1000000010000001000CCCCCC0000000000100000001
1000000011111111000CCCCCC0001111111100000001
10000000000000010000CCCC00001000000000000001
100000000000000100000CC000001000000000000001
10000000000000010000000000001111111100000001
100000000000000000000000000000000000000000E1
11111111111111111111111111111111111111111111

