1111111111111111
1PP00000000C0001
1011111111111011
1000000000000011
1111011111111111
1C000000000EE001
1111111111111111
