1111111111111111
1P000000000C0001
1011111111111011
1000000000000011
1111011111111111
1C000000000E0001
1111111111111111
1       1      1
1       1      1  
